September 4, 2003
1. Orilene – Sanctuary (Lemon 8 Remix) (Bandung)
2. Scarab – Vagabond (Miika Kuisma Remix) (ASOT)
3. Hemstock & Jennings feat Adam White – Reverence (CDR)
4. TUNE OF THE WEEK: Mr Sam vs Tim Coltrane presents The Tribute – One More Day (Original Mix)
5. Musix – Cyber Desire (Club Elite)
6. 4 Strings – Eastern Vibe (Spinnin)
7. Armin van Buuren feat Justine Suissa – Burned With Desire (Rising Star Remix) (United)
8. Critical Seven – Lost (Pesh Remix) (Lost Language)
1. Paul van Dyk – Connected (Markus Schulz Rework)
2. Motorcycle – As The Rush Comes (Markus Schulz Coldharbour Remix) (Armada)
3. Conjure One – Centre Of The Sun (Junkie XL Remix) (Nettwerk)
4. Lost Tribe – Gamemaster (Shane 54 Remix) (CDR)
5. St John vs Locust – Mind Circles (CDR)
6. Andain – Beautiful Things (Josh Gabriel Tech Mix) (Blackhole UK/Nebula)
7. John Askew – Skylab (Kyau vs Albert Remix) (Discover)
8. A-force- Continental Chaos (Fundamental)
1. Usual Aspect – Mr Blue (CDR)
2. LNG – Intercity (Tsunami)
3. Armin van Buuren vs Airwave – Slipstream (United)
4. Vector 7 meets Blair Bitch – Natural Thing (KyR)
5. Lange – I Believe 2003 (Lange Remix)
6. Unknown Artist – Killimanjaaro (CDR)
7. Ronski Speed – Iris (Euphonic)
8. Firewall – Sincere (Pulser Remix) (ASOT)
9. Pirate – Leaving The Sun (Ferry Corsten Instrumental Mix)
1. Hemstock & Jennings – Mirage Of Hope (Lange Remix)(Five AM)
2. Firewall – Sincere (Original Mix) (ASOT)
3. Ernesto vs Bastian – A Few Seconds After Trancefer (FTM)
4. Robert Lidstroem – My Spirit (Transa vs Inzite Remix) (Exciter)
5. Nalin & Kane – Beachball (Original Mix)
6. Salt Tank – Eugina