October 2, 2003
1. Jewel – Stand (Markus Schulz Coldharbour remix) (Atlantic)
2. Boss@nova – Stonecold (Tsunami)
3. Firewall – Sincere (Pulser remix) (ASOT)
4. TUNE OF THE WEEK: Delerium – Truly (Signum Intro mix) (Nettwerk)
5. Mind One – Only memories (Torpedo)
6. Matt Hardwick vs. Smith & Pledger- Day One (Anjunabeats)
7. JS Ten – Eternal (Euphonic mix) (Blue Print)
8. Empyrical Labs – Turtle beach (Outback mix)
9. Masters & Nickson feat. Justine Suissa – Out there (C-Quence remix) (Soundpiercing)
10. Euphonic – Asia
1. Elevation – Clear Blue (Armada)
2. Andain – Beautiful Things (accapella) (Blackhole)
3. Agoria – La Onzieme Marche (Phil Kieran mix)(Pias)
4. Attention Deficit – What (CDR)
5. Razor n Guido – The Build up (Reddline)
6. Andain – Beatiful Things (Blackhole)
1. Brother Brown – Star Catching girl (Smith & Selway remix) (MOS)
2. Lilly Hayden – Anything (Gabriel & Dresden Code 313 dub)
3. Remy – Dustsucker with Tom McGrae – You only disappear
4. The Youngsters – Break Them Off
5. Annie Lennox – Pavement Cracks (Gabriel & Dresden club mix)
1. Motorcycle – As The Rush Comes (Sweeping Strings Chill Out Remix)
2. Layo & Bushwacka – Let The Good Times Roll (Josh Gabriel
3. Gabriel & Dresden – Acid Elliot
4. Depeche Mode – Here Is The House (Gabriel & Dresden Bootleg)
5. Evanescence – Hello (Gabriel & Dresden Bootleg)
6. Gabriel & Dresden – Serendipity vs Coldplay – Clocks (Gabriel &
1. Nalin & Kane – Beachball (Level K mix) (Superfly)
2. Ronald Klinkenberg – Monday Groove (CDR)
3. Masssive Lust – Never (Corvin Dalek’s Lustgarden mix) (Maelstrom)
4. Unknown Artist – Unknown Title
5. Nathan Fake – Outhouse (Border Community)
6. Scott Bond vs. Solarstone – Naked Angel (CDR)
7. Smuel & Choopie – Sunrising (edit)(Agnosia)
8. Koglin & Dewar aka ‘State One’ – Pushed On (Noys)
9. The Gift – Seventh Day (ID&T)