November 6, 2003
1. UNKLE – In A State (Sasha Remix)
2. Yet Another Day vs Suburban Train (ASOT special)
3. Oceanlab feat. Justine Suissa – Satellite (Anjunabeats)
4. TUNE OF THE WEEK: Sarah McLachlan – Falling (Gabriel & Dresden Remix) (Nettwerk)
5. LSG – Fontana (Venus Remix) (Superstition)
6. Katana – One Solid Wave (CDR)
7. Arctic Quest – Raygun (Relic Mix)
8. Mark Otten – Mushroom Therapy (Armin van Buuren’s Precious Remix) (Armind)
1. Perry O’Neil – Kubik (Intro Mix) (EE)
2. Portishead – Roads (Sultan & Tone Depth Remix) (rr1000)
3. Blackwatch & Quivver – Loveless
4. Ferry Corsten vs The Thrillseekers – Sublime (Tsunami)
5. Octagen & Arizona – Starburst
6. Filo & Peri – I95
7. Astral Projection – Mahadeva (John ’00′ Fleming Remix) (Joof)
8. Agnelli & Nelson – Holding On To Nothing (CDR)
1. Dark Suite feat Aura – Dark Sweet Piano (Accapella)
2. Andain – Beautiful Things (Elevation Remix)
3. Piece Process – Solar Myth (Markus Schulz Remix)
4. Luke Chable & Danny Bonicci – Ride
5. Oceanlab feat Justine Suissa – Satellite (Markus Schulz Coldharbour
6. Peter Martin – Perfect Wave (Markus Schulz Edit)
7. St John vs Locust – Mind Circles (Locust Remix)
8. Whirlpool – Under The Sun (Original Mix)
9. Paul van Dyk – Connected (Markus Schulz Reconstruction)
1. Motorcycle – As The Rush Comes (Markus Schulz Coldharbour Remix)
2. Markus Schulz presents Elevation – Clear Blue (Intro Mix) (EE)
3. Telepopmusic – Breathe (Markus Schulz Remix)
4. Jewel – Stand (Markus Schulz Coldharbour Remix)
5. PQM – The Flying Song (Markus Schulz Remix)
6. Karada – Last Flight (Markus Schulz Return To Coldharbour Remix) (Lost
7. Jewel – Intuition (Markus Schulz Coldharbour Remix)