January 8, 2004
1. Whirlpool – Under The Sun (Solar Stone Remix) (Deep Blue)
2. Envio – Time To Say Goodbye (Passiva Remix) (ASOT)
3. Armin van Buuren feat Justine Suissa – Burned With Desire (Ronski Speed Vocal Mix)(Euphonic/ United)
4. TUNE OF THE WEEK: Super8 – Alba (Anjunabeats)
5. Fictivision vs Phynn – Escape (Phynn Mix) (Blackhole)
6. Agnelli & Nelson presents Ultra – Holding On To Nothing (Deep Mix)
7. Sonicvibe vs Mike Shiver – Lunation (Masters & Nickson Mix)
8. FUTURE FAVORITE: Havannah – Havannah (Original Mix) (TRR)
1. Luminary – My World (Lost Language)
2. Unknown tune (Perry O Neil Dub)
3. Beastie Boys – Intergalactic Planetary (Matthew Dekay bootleg)
4. Piere Ravan & Safar – Divine Energy (Shinichi)
5. Pinkbox Special – Simple (CDR)
6. George Hales – Autumn (Locust vs St John Remix)(Somatic Sense)
7. Empire State – Niagara (Lost Language)
8. Sarah McLachlan – Fallen (Gabriel & Dresden Anti Gravity Mix) (Nettwerk)
1. Arksun – Time (Lost Language)
2. Sasha – Wavy Gravy (Terry Bones Remix) (CDR)
3. Active Sight – The Search For Freedom (Armada)
4. Push – Electric Eclipse (Banshee)
5. 8 Wonders – The Morning After (Octagen Remix) (Somatic Sense)
6. Kyau vs Albert – Velvet Morning (Aalto Remix) (Anjunabeats/ Euphonic)
7. Yahel – Avalanche (Senses Remix) (Fundamental)
8. Shmuel & Choopie – Sunrising (Blackhole)
1. Hatrixx – Windeo (Yeti)
2. Katana – One Solid Wave (Spinnin)
3. Red Karma featuring Tom Wolf – From One To Another (Armada)
4. True Form – Forbidden Colours (CDR)
5. Oceanlab – Satellite (Original Mix) (Anjunabeats)
6. Robert Nickson – Spiral (CDR)
7. DITO – Iceland (Torpedo)
8. Perpetuous Dreamer – Future Funland (Astura Remix) (Fundamental)
9. Primolux – Turnpoint (Fundamental)