February 5, 2004
1. Li-Kwan – Point Zero (Li Kwan 2004 Remix)
2. Signum – Come Around Again (ASOT)
3. Jas van Houten – Loco Love (Shah)
4. TUNE OF THE WEEK: Waterplanet – Introspection (John Askew Remix)
5. True Form – Forbidden Colours (CDR)
6. FUTURE FAVORITE: Electrovoya – Whispers (Fundamental)
7. Solid Globe – Sahara (Fundamental)
8. Joop – Sonsuz (Mark Norman Remix) (ID&T)
1. Ozgur Can – Connected
2. St John vs Locust – Mind Circles (Locust Remix)
3. Unknown Artist – Unknown Title
4. Recluse – Emotional Void
5. Dreas & Bjorn present Havannah – Havannah (TRR)
6. Blank & Jones feat. Elles De Graaf – Mind Of The Wonderful (Hiver & Hammer dub)
7. Salt Lake – Rendezvous (Dedicated)
8. DJ Fire – Religion (Banshee)
9. Sander van Doorn – Loaded (Spinnin)
1. Gwill Morris – Forme (Leama & Moor Remix)
2. Probspot – Midnight
3. Miro – By Your Side (Sonorous Remix)
4. Mike Hiratzka – Things can only get better
5. DJ Yoshi – Dreamer (Luke Chable Remix)
6. Descent – Round Midnight
7. Li-Kwan – Point Zero (Leama & Moor Remix)
8. Whiteroom – Whiteroom
1. Solar Stone – Solar Coaster (Original Mix)
2. Lyric & Natalie – Over Emotion
3. Roland Klinkenberg – Inner Laugh (Steve Porter Remix)
4. Cultivate – Broken Pieces (Max Graham Third Street Remix)
5. Ballroom – Passenger (Marc O’Tool Remix)
6. Solar Stone – Seven Cities (Michael Woods Remix)
7. Origin – Wide Eyed Angel (Inversion Mix)