March 4, 2004
1. Probspot – Foreplay
2. Nickelson – Yin (Solid Globe Remix)
3. Mark Norman – Rush (Blackhole/Magik Muzik)
4. TUNE OF THE WEEK: Above & Beyond – No One On Earth (Anjunabeats)
5. BT – Force Of Gravity (Tiesto Remix) (Nettwerk)
6. FUTURE FAVORITE: Witness Of Wonder – Emotions In Motion (Thrillseekers Remix) (ATCR)
7. Red Karma featuring Tom Wolf – From one to Another (Captivating)
8. Unknown Artist – Once Upon A Time (CDR)
1. jaydee production – unknown title
2. The Groove Pirates – Electrical Storm
3. Sergio Fernandez – Awake Minds
4. Element N – On a mission
5. Marco V – Echnalava
6. Faserbase – Right Behind you
7. Rio Klein – Fearless (Agnelli & Nelson Remix)
8. Rare Candy – Pachino
9. Dreas presents Havannah – Havannah (TRR)
1. DJ Danjo & Rob Styles – Duende
2. Primer – The Silver Lining (Banshee)
3. Sander van Doorn – Loaded (SVD Remix) (Spinnin)
4. Mojado featuring Mr Sam – Naranja (Mr Sam Vision)(Blackhole)
5. Midway – Amazon (Mesh Remix) (Blackhole)
6. Cern – The Message (Southern Mix) (ASOT)
7. Mark Norman – Shine
8. Mark Norman – Rush (Blackhole/Magik Muzik)
9. Mojado featuring Mr Sam – Naranja (Dimitri Andreas Vision)
1. Crescendo – External Key
2. Gwill Morris – Forme (Leama & Moor Remix) (precinct)
3. Perry O’Neil – Fuel
4. Arksun – Time
5. True Form – Forbidden Colours
6. Sensorica – Few Days Away (Original mix)
7. Kuffdam & Plant – Seduction (Joof)
8. DJ Tab – Verso (Anjunabeats)