October 21, 2004
1. Statica – Space Guitar (CDR)
2. Kyau vs. Albert – Made Of Sun (KYA Hard Dub)(Euphonic)
3. Dogzilla – Your Eyes (Dimitri Andreas Remix) (Maelstrom)
4. TUNE OF THE WEEK: Mike Koglin – The Silence 2005
5. Unknown Artist – Earth’s Breathing (CDR)
6. FUTURE FAVORITE: Jan Gustafsson – Trance.nu Winter Dance Event Theme (Fundamental)
7. Robert Nickson – Twisted By Design (ASOT)
8. Ronald van Gelderen – Cold Storage (ID&T)
1. Taucher & Marc Vision pres Vita – Unknown Title (DMD)
2. Departure – She Turns (Markus Schulz Remix)
3. Max Graham feat. Jessica Riddle – Gone
4. Airwave – Save Me (Whiteroom Mix)(Monster classics)
5. Plastic Angel – Siren (Afterglow)
6. Plastic Boy – Twixt 2004 (Banshee)
7. Marcos – Cosmic Strings (Vandit)
8. Young Parisians feat. Ben Lost – Jump The Next Train (Kyau vs Albert Remix)(Deep Blue/Euphonic)
9. John O’Callaghan & Bryan Keamey – Restricted Moon (Discover)
1. Alucard – Blu On Blu (George Hales Remix)
2. Radiate – Crystal Clear (Sonar Methods Mix)
3. Fractal Structure – Lost Sequence (Haak’s Subliminal Cowbell Mix)
4. Activa featuring Aled Mann – In Essence (Matt Hardwick
5. Signal Runners – Back Fire (Original Mix)
6. Symmetry – Forget (Sonicvibe Remix)
7. Carl B – All Day
1. Mike Shiver & Elevation featuring Carrie Skipper – Hurricane
2. Haak vs Nickon – Untitled
3. DJ Albert vs Precision – Say Yes (Original Mix)
4. DJ Precision presents M.I.D.O.R. & Six4Eight – Cloud City
5. 8 Wonders – The Morning After (Thrillseekers Remix)
6. M.I.D.O.R. & Six4Eight featuring DJ Precision – Far East
7. Viframa – Cristalle (Katana feat. DJ Precision Remix)
8. Fractal Structure – Lost Sequence (Original Mix)