August 15, 2013
1. BT - Vervoeren [Armada]
2. Omnia - Immersion (Original Mix) [Armind]
3. Super8 & Tab - The Way You Want (Original Mix) [Anjunabeats]
4. Ronski Speed and LTN ft. Renee Stahl - Something Real (Original Mix) (from the album 'Second World') [Euphonic]
5. Terry Da Libra & David Broaders - Loss Aversion (Original Mix) [Enhanced]
6. Toby Hedges - Images (Original Mix) [Royal Records]
7. FUTURE FAVORITE: Dash Berlin feat. Christina Novelli - Jar Of Hearts (Club Mix) [Aropa]
8. ATB with Dash Berlin - Apollo Road (Toby Hedges Remix) [Aropa]
9. Dash Berlin ft. Sarah Howells - Go It Alone (Andrew Rayel Remix) [Aropa]
10. Dash Berlin feat. Shanokee - Surrender (Arctic Moon Remix) [Aropa]
11. Mark Knight, D. Ramirez vs Underworld - Downpipe (Armin van Buuren remix)[Toolroom]
12. Joint Operations Centre - Under a Sea of Birds [Subculture]
13. Ferry Corsten - Diss! [Flashover]
14. Fast Distance - Reckless (Original Mix) [Digital Society/Enhanced]
15. Grube & Hovsepian - Trickster (Original Mix) [Coldharbour]
16. BT, Tritonal & Emma Hewitt - Calling Your Name [Armada]
17. Luke Bond - Reflections (Tomas Heredia Remix) [FSOE]
18. TUNE OF THE WEEK: Arisen Flame - Unity (Original Mix) [Armada]
19. Rob Naylor - Head North (Original Mix) [Garuda]
20. Nianaro - Gethsemane (Original Mix) [Profound]
21. Estiva - Dinodrums vs. Paul van Dyk - Don't Deserve You Accapella (AvB Mash Up)
22. Ciro Visone - Flying On The Moon (Ian Standerwick Remix) [Digitized]
23. Amir Hussain - Catharsis (Original Mix) [Monster Tunes]
24. Ben Nicky & James Dymond - Refresh (Original Mix) [Mental Asylum]
25. Photographer - This Is Upstep (Original Mix) [Digitized]
26. Kaimo K and Cate Kanell - The Mystery (Original Mix) [Amsterdam Trance Records]
27. Signum - Any Given Moment (Manuel Le Saux remix) [Armada]
28. Turn & Natali Kryzhanovski - Renaissance (Odonbat Remix) [Blue Soho]
29. Deathmind - Bang! (Original Mix) [Discover Dark]
30. ASOT Radio Classic: Traveller - Bright Sign (Remastered) [ASOT Classics vol. 8]