May 1, 2014, <a href="http://www.astateoftrance.com/tag/radio/" rel="tag">radio</a>, <a href="http://www.astateoftrance.com/tag/tracklist/" rel="tag">tracklist</a>
1. Funkagenda - One Day At A Time [Trice]
2. EDU - Action Hero (Progressive Mix) [Macarize]
3. Maywave - Live For Something [Cloudland]
4. Cosmic Gate & Eric Lumiere - Falling Back [WYM]
5. Rafael Frost - Wildcard [Frost]
6. Facepalm - Flatland (Andre Sobota Remix) [Saturate Audio]
7. Protoculture feat. Ilana - Vertigo (Taken From Music Is More Than Mathematics) [Rebrand]
8. Protoculture & Max Graham - Axiom (Taken From Music Is More Than Mathematics) [Rebrand]
9. Protoculture feat. Tricia McTeague - Burning Bridges (Taken From Music Is More Than Mathematics) [Rebrand]
10. Protoculture & Shane Halcon with Jennifer Rene - Northern Lights (Taken From Music Is More Than Mathematics) [Rebrand]
11. Capital Cities - Safe & Sound (Markus Schulz vs. Grube & Hovsepian Extended Mix) [Coldharbour]
12. Beat Service - #HEY [Beat Service Audio]
13. Shogun - Zanarkand [Armind]
14. Alexandre Bergheau - Symptom [Captivating Sounds]
15. Heatbeat - Aerys [Captivating Sounds]
16. TUNE OF THE WEEK: David Gravell - Timebomb [ASOT]
17. Armin van Buuren - Ping Pong (Kryder & Tom Staar Remix) [Armind]
18. Stoneface & Terminal with Ellie Lawson - For You [Euphonic]
19. Maarten de Jong - Red and White [Vandit Records]
20. Dan Thompson - Altitude [ASOT]
21. Robbie Seed - Cosmopolia (Biotones Remix) [Blue Soho]
22. Paul Oakenfold - Madagascar [Perfecto Fluoro]
23. FUTURE FAVORITE: Harmonic Rush - The Dark Side Of Persia (Ahmed Romel Remix)
24. Mark Sherry & 3DW vs Madders feat Debbie Sharp - Feel So Right [Mental Asylum]
25. Touchstone - Stargazer [Digital Society]
26. Aly & Fila feat.Karim Youssef - Laily (Photographer Remix) [FSOE]
27. Touchstone & First Effect - Chronology [Silent Shore 200]
28. The Thrillseekers Vs Sam Mitcham - All The Little Things (A.R.D.I. Remix) [Adjusted]
29. Sam Jones & Will Rees - Fire Drill (Chris Metcalfe remix)
30. Harmonic Rush - Head Rush [Monster Tunes]
31. ASOT Radio Classic: Super8 & Tab - Helsinki Scorching [Anjunabeats]