April 16, 2015, <a href="http://www.astateoftrance.com/tag/radio/" rel="tag">radio</a>, <a href="http://www.astateoftrance.com/tag/tracklist/" rel="tag">tracklist</a>
1. TUNE OF THE WEEK: Armin van Buuren feat. Mr. Probz - - Another You [Armada]
2. HOTMIX START: Kenneth Thomas feat. Colleen Riley - The Heart Speaks (Roddy Reyneart Remix) [Perfecto]
3. Oliver Englafjord - Molntus (Luke Chable Remix) [Blackhole]
4. Dawn - The Truth We Can't Escape [ASOT]
5. Trending Track: Eric Prydz - Generate [Pryda]
6. Orjan Nilsen - Amis Ama [IMO]
7. Markus Schulz feat Delacey - Destiny [Coldharbour]
8. Andrew Rayel feat. Sylvia Tosun - We Bring The Love [Armind]
9. Venom One & Tomas Heredia - Moments [ASOT]
10. Alex Kunnari - Runaway Train [Magik Muzik]
11. Alexander Popov - Born To Love [Armind]
12. Dennis Sheperd & Katty Heath - Where I Begin (Taken from ’Fight Your Fears’) [A Tribute To Life]
13. Dennis Sheperd & Cold Blue & Ana Criado - Every Word (Taken from ’Fight Your Fears’) [A Tribute To Life]
14. Dennis Sheperd feat. Christina Novelli - Starlight (Taken from ’Fight Your Fears’) [A Tribute To Life]
15. Vini Vici - The Tribe [Iboga]
16. PROGRESSIVE PICK START: LTN & Anuskha Desai - Dreams Of Maya [Enhanced]
17. Luke Chable - Comet [Z3/Toolroom]
18. Luke Chable - Echo [Z3/Toolroom]
19. <strong>NONSTOP IN THE MIX: Sonic Element - </strong>Vulnerable [Transistic]
20. Johnny Yono - Lucid Eyes [Perfecto]
21. Andy Elliass & ARCZI - Subcarpathia [FSOE EX]
22. Arty - Hope (Airbase Remix) [Flashover]
23. Photographer & Susana - Find A Way [How Trance Works]
24. David Ether - Severed (Assaf Remix)
25. Gaia - Carnation (Abstract Vision & Aimoon Bootleg)
26. Allen & Envy - Elixir (Taken from ’Future Sound of Egypt Vol.3’) [FSOE]
27. James Dymond - Renegade (Taken from ’Future Sound of Egypt Vol.3’) [FSOE]
28. Illitheas - Endless [Abora Skies]
29. Re:Locate vs. Robert Nickson - Vivid [Molekular Sounds]
30. FUTURE FAVORITE: Bobina - Flying Kitten (Taken from ’Bobina - Uplifting’) [Magik Muzik]
31. Bobina - Invisible Touch (Aly & Fila Remix) (Taken from ’Bobina - Uplifting’) [Black Hole]
32. Bobina - Nos Encontramos (ReOrder Remix) (Taken from ’Bobina - Uplifting’) [Black Hole]
33. Standerwick - Dark Matter [Mental Asylum]
34. ASOT Radio Classic: Sunscreem vs. Push - Please Save Me [Bonzai]