May 14, 2015, <a href="http://www.astateoftrance.com/tag/news-2/" rel="tag">news</a>, <a href="http://www.astateoftrance.com/tag/radio/" rel="tag">radio</a>
1. HOTMIX START: Meyce presents ONE WAY feat. Heidi Anne - Wonderland (Alexander Popov & Steve Nyman Remix) (Taken from Interplay) [Armada]
2. Kyau & Albert - Color Field [Anjunabeats]
3. Above & Beyond feat. ZoÃ« Johnston - We're All We Need (ilan Bluestone Remix) [Anjunabeats]
4. TRENDING TRACK: Gareth Emery - Kings & Queens [Garuda]
5. Andrew Rayel with Bobina - Sacramentum (DRYM Remix) [Armada]
6. Arston feat. Jake Reese - Circle Track [Armada]
7. David Gravell feat. Christon - It's In Your Heart (Club Mix) [Armada Captivating]
8. Alexander Turok - Loud & Clear (Taken from Interplay) [Armada]
9. Arisen Flame - Fireball [ASOT]
10. Square Two - Split [Enhanced]
11. Armin van Buuren ft. Mr Probz - Another You (Headhunterz Remix) [Armind]
12. Andrew Rayel - Power Of Elements (Arisen Flame Remix) [Armada]
13. TUNE OF THE WEEK: MaRLo - Atlantis [ASOT]
14. Sied van Riel & Radion 6 - Warpdrive [Armind]
15. Dimension - Origami (Ferry Tayle Emotional Remix) [Flashover]
16. FUTURE FAVORITE: Andy Moor & RAM feat. Christina Novelli - All Gone (RAM Uplifting Mix) [WAO138]
17. PROGRESSIVE PICK: Orbion - Timeless [Alter Ego]
18. HOUR TWO: Ahmed Romel & Hazem Beltagui - Nihavent (Tomac Remix)
19. Mohamed Ragab & Mino Safy - Meronym [FSOEEX]
20. Alexander Popov & Yan Space - Fractal (Taken from Interplay) [Armada]
21. Alexander Popov - Personal Way (Arisen Flame Remix) (Taken from Interplay) [Armada]
22. Johnny Yono - Embrace The Fear [Lange]
23. Nifra & Artisan - Rampage [Coldharbour]
24. Matt Darey Presents Urban Astronauts feat. Kate Louise Smith - See The Sun (Dan Stone Rework) [FSOE]
25. Paul van Dyk and Jordan Suckley - City Of Sound [Vandit]
26. Ciaran McAuley & Clare Stagg - Firebird
27. Future Antics - Stargaze [Monster Tunes]
28. Andy Elliass - Elizjum [Blue Soho]
29. Bryn Liedl feat Bethany Marie - Statues (Bryan Kearney Remix) [Go On Air]
30. Kayosa & Tolland feat. Matt Noland - Sisa [Monster Tunes]
31. Jordan Suckley - Medic (Arctic Moon Remix) [Damaged]
32. Sunset - Rotterdam [Ghost Tunes]
33. Andres Sanchez - Don't Leave [Subculture]
34. ASOT Radio Classic: Cygnus X - Positron (Armin van Buuren Remix) [High Contrast Recordings (Be Yourself Music)]