May 21, 2015, <a href="http://www.astateoftrance.com/tag/news-2/" rel="tag">news</a>, <a href="http://www.astateoftrance.com/tag/radio/" rel="tag">radio</a>
1. Andrew Rayel feat. Jonny Rose - Daylight (Taken from 'Find Your Harmony Deluxe') [Armada]
2. Above & Beyond - Hello (Jerome Isma-Ae Remix) (Taken from 'Anjunabeats Worldwide 05') [Anjunabeats]
3. ilan Bluestone - Cloudchaser (Taken from 'Anjunabeats Worldwide 05') [Anjunabeats]
4. Jenaux feat. Pia Toscano - Renegades (Willem de Roo Remix) [Enhanced]
5. Adara - Chemistry (LTN Remix)
6. Spencer Tarring feat. Angelika Vee - Fall Down (Protoculture Remix) [Revealed]
7. Monoverse - One Way To LA [Statement!]
8. Airbase - Mondegreen [ASOT]
9. TUNE OF THE WEEK: Jean-Michel Jarre & Tangerine Dream - Zero Gravity (Above & Beyond Remix) [Anjunabeats]
10. Rafael Frost & Maria Nayler - No Mistakes [Frost Recordings]
11. Jason Seizures - Fat Toddler (Tom Fall Remode) [Digital Insomnia Groove]
12. Harmonic Rush & Binary Finary - Rise (Craig Connelly Remix) [Rise]
13. Arisen Flame - Fireball [ASOT]
14. MaRLo - Atlantis [ASOT]
15. Alexander Popov - Personal Way (Arisen Flame Remix) [Armada]
16. Gareth Emery - Huracan (Ben Gold Remix) [Garuda]
17. FUTURE FAVORITE: Ahmed Romel & Hazem Beltagui - Nihavent (Tomac Remix)
18. PROGRESSIVE PICK: Grum - U [Anjunabeats]
19. HOUR TWO: Armin van Buuren & Andrew Rayel - EIFORYA (Alexander Popov Remix) (Taken from 'Find Your Harmony Deluxe') [Armada]
20. Andrew Rayel - Impulse (Bobina Remix) (Taken from 'Find Your Harmony Deluxe') [Armada]
21. Andrew Rayel - Rise Of The Era (Digital X Remix) (Taken from 'Find Your Harmony Deluxe') [Armada]
22. Andrew Rayel feat. Sylvia Tosun - There Are No Words (Faruk Sabanci Remix) (Taken from 'Find Your Harmony Deluxe') [Armada]
23. Andrew Rayel feat. Alexandra Badoi - Goodbye (Ben Gold Remix) (Taken from 'Find Your Harmony Deluxe') [Armada]
24. Antillas - Route 66 (Dan Thompson Remix) [IHU]
25. Mohamed Ragab & Mino Safy - Meronym [FSOEEX]
26. Ultimate & Moonsouls - U And Us (Original Mix) [Infrasonic]
27. Dan Stone - Radi8 [Free Download]
28. Pulser - My Religion (Astuni And Manuel Le Saux Re-lift) [WAO138?!]
29. TRENDING TRACK: Bryn Liedl feat Bethany Marie - Statues (Bryan Kearney Remix) (Taken from 'This Is Kearnage') [Go On Air]
30. Bryan Kearney & Will Rees - Prime Example (Taken from 'This Is Kearnage') [Kearnage]
31. Sam Jones - Let Loose (Taken from 'This Is Kearnage') [Kearnage]
32. Jase Thirwall - StandBy (Taken from 'This Is Kearnage') [Mental Asylum]
33. Will Rees - Persistence [FSOE]
34. ASOT Radio Classic: Marcel Woods - Cherry Blossom [High Contrast]