June 11, 2015, <a href="http://www.astateoftrance.com/tag/news-2/" rel="tag">news</a>, <a href="http://www.astateoftrance.com/tag/radio/" rel="tag">radio</a>
1. Matt Fax - Supertaper [ZeroThree]
2. Karanda - Supreme [Frost Recordings]
3. TUNE OF THE WEEK: Cosmic Gate with Eric Lumiere - Run Away (Alexander Popov Remix) [Wake Your Mind]
4. Aruna - The End (Alex Klingle Remix) [Enhanced]
5. Cosmic Gate with Sarah Lynn - Sparks After The Sunset (Rafaël Frost Remix) [Wake Your Mind]
6. Arctic Lake - Limits (Aurosonic Progressive Mix) [Soho Yacht Club]
7. Aelyn - New Day (Original Mix) [How Trance Works]
8. Ronski Speed ft. Lucy Saunders - Calm Before The Storm (Aimoon Remix) (Taken from New Breed) [Macaraido]
9. Hardwell feat Jonathan Mendelsohn - Echos (Tenishia Remix)
10. MaRLo - Atlantis [ASOT]
11. Markus Schulz feat Delacey - Destiny (Kyau & Albert Remix) [Coldharbour]
12. Tom Fall feat. Laces - Break Free [Armada Trice]
13. PROGRESSIVE PICK: Rodg - Wrong Direction (Taken from A State of Trance Festival 2015) [Armada]
14. Cuebrick - Demon (Kago Pengchi Remix) [Enhanced]
15. Jean-Michel Jarre vs Corti Organ - Zero Gravity vs Butterfly (Armin van Buuren Mash-Up)
16. Joonas Hahmo X K-System - Ocean Drive [Hahmo Recordings]
17. Denis Sender & DJ T.H. with Hanna Finsen - New Day (Mino Safy Remix) [Entrancing]
18. Reverse - Distant Destiny (Dan Dobson Bootleg) [Vandit]
19. TRENDING TRACK: Ferry Corsten presents Gouryella - Anahera [Flashover]
20. Airscape vs Peetu S. - Pianomatic (Airscape Festival Mix) [High Contrast]
21. Lee Osborne feat. Roxanne Emery - Safe In The Sky (Cold Rush Remix) [Monster Tunes]
22. Allen & Envy and Katty Heath - I Wasn't The One (Cold Rush Remix) [How Trance Works]
23. Iversoon & Alex Daf feat. Eireann Wax - State of Oblivion (Woody van Eyden Remix) [Fenology]
24. Adam Ellis and Katty Heath - Made It Through The Rain [RNM]
25. Orkidea with Activa - Z21 (Taken from Harmonia) [Blackhole]
26. Moonsouls - Sparkles (Cold Rush Remix) [Infrasonic]
27. Tycoos - The Road Less Traveled [Synchronized Music]
28. John Askew - The Door (John Askew Remix)
29. FUTURE FAVORITE: Ramin Djawadi - Game of Thrones (Armin van Buuren Remix) [Armind]
30. Starfighter - Apache (John O’Callaghan Remix) [Subculture]
31. Paul Denton - Wire Tap [Tytanium]
32. ASOT Radio Classic: Mike presents Plastic Boy - Chocolate Infusion [Armada Captivating]